#######################
#O.........#.........O#
#.###.####.#.####.###.#
#.###.####.#.####.###.#
#.....................#
#.###.#.#######.#.###.#
#.....#....#....#.....#
#####.####.#.####.#####
    #.#.........#.#    
#####.#.###.###.#.#####
#.......#ggggg#.......#
#####.#.###.###.#.#####
    #.#.........#.#
#####.#.#######.#.#####
#..........#..........#
#.###.####.#.####.###.#
#...#...........#.....#
###.#.#.#######.#.#.###
#.....#....#.....p#...#
#.########.#.########.#
#O...................O#
#######################
